*********
**  *  E 
*   * * *
* ***  * 
* * * * *
*  *  *  
**  S  **
*      * 
*********