********************
*  **   *   ****   *
**  * *      **  * *
* *  *   *     *   *
*  *   *   ***   ***
*     *    *    *  *
*  **   **   **  * *
* *E *  *  *  *    *
*  *    *    S   ***
********************