*********
*E  *    
** ** * *
*   * * *
*  * * **
* * *   *
*  *S* **
*      * 
*********