*E*******
*   *   
*  *** * 
* * *  * 
* * *** *
*  *  *  
**  S * *
*     *  
*********